-1 -1 -1 -1 -1 -1 -1 -1 -1 -1 -1 -1 -1 -1 -1 -1 -1 -1 -1
-1 -1 193 194 195 64 191 89 191 89 191 89 76 257 258 259 -1 -1 -1
-1 -1 196 197 198 64 192 91 192 91 192 91 80 260 261 262 -1 -1 -1
-1 -1 199 200 201 64 92 93 92 93 92 93 84 263 264 265 100 -1 -1
-1 -1 202 203 -1 -1 66 66 66 67 73 68 65 65 65 65 101 -1 -1
47 47 204 205 206 -1 -1 -1 -1 -1 -1 -1 -1 -1 -1 -1 -1 -1 -1
48 48 207 208 209 -1 -1 -1 -1 -1 -1 -1 -1 -1 -1 -1 -1 -1 -1
-1 -1 -1 -1 -1 -1 -1 218 219 220 221 222 223 224 109 110 -1 210 211
-1 -1 -1 -1 -1 -1 -1 225 226 227 228 229 230 231 111 112 212 213 214
-1 -1 -1 -1 -1 -1 -1 232 233 234 235 236 237 238 113 114 215 216 217
-1 -1 -1 -1 -1 -1 -1 239 240 241 242 243 244 245 115 210 211 116 -1
-1 -1 -1 -1 -1 -1 -1 -1 246 247 248 249 250 251 212 213 214 117 -1
-1 -1 -1 -1 -1 -1 -1 -1 -1 -1 -1 -1 -1 -1 215 216 217 -1 -1
-1 -1 -1 -1 -1 -1 -1 -1 -1 -1 -1 -1 -1 -1 -1 -1 -1 -1 74
-1 -1 -1 -1 -1 -1 -1 -1 -1 -1 -1 -1 -1 -1 -1 -1 -1 -1 75
178 179 179 179 180 -1 252 253 252 253 252 253 -1 -1 -1 -1 -1 -1 69
181 182 182 182 183 -1 254 255 254 255 254 255 -1 170 171 -1 -1 -1 70
184 185 185 185 186 -1 252 253 252 253 252 253 -1 172 173 -1 -1 -1 71
187 188 188 188 189 -1 254 255 254 255 254 255 -1 174 175 -1 -1 -1 72
-1 -1 -1 -1 -1 -1 252 253 252 253 252 253 -1 176 177 -1 -1 -1 65
-1 -1 -1 -1 -1 -1 254 255 254 255 254 255 -1 -1 -1 -1 -1 -1 -1
