0 1 1 1 1 1 1 1 1 1 1 1 1 1 1 1 1 1 2
3 4 4 4 4 4 4 4 4 4 4 4 4 4 4 4 4 4 5
3 4 4 4 4 4 4 4 4 4 4 4 4 4 4 4 4 4 5
3 4 4 4 4 4 4 4 4 4 4 4 4 4 4 4 4 4 5
3 4 4 4 4 4 4 4 4 4 4 4 4 4 4 4 4 4 5
3 4 4 4 4 17 18 9 10 9 10 9 10 9 10 9 10 9 10
3 4 4 4 4 19 20 11 12 11 12 11 12 11 12 11 12 11 12
3 4 4 4 4 13 14 29 29 29 29 29 29 29 29 29 29 29 29
3 4 4 4 4 15 16 29 29 29 29 29 29 29 29 29 29 29 29
3 4 4 4 4 13 14 29 29 29 29 29 29 29 29 29 29 29 29
3 4 4 4 4 15 16 29 29 29 29 29 29 29 29 29 29 29 29
3 4 4 4 4 13 14 29 29 29 29 29 29 29 29 29 29 29 29
3 4 4 4 4 15 16 29 29 29 29 29 29 29 29 29 29 29 29
3 4 4 4 4 25 26 9 10 9 10 9 10 9 10 9 21 22 4
3 4 4 4 4 27 28 11 12 11 12 11 12 11 12 11 23 24 4
3 4 4 4 4 4 4 4 4 4 4 4 4 4 4 4 13 14 4
3 4 4 4 4 4 4 4 4 4 4 4 4 4 4 4 15 16 4
3 4 4 4 4 4 4 4 4 4 4 4 4 4 4 4 13 14 4
3 4 4 4 4 4 4 4 4 4 4 4 4 4 4 4 15 16 4
3 4 4 4 4 4 4 4 4 4 4 4 4 4 4 4 13 14 4
6 7 7 7 7 7 7 7 7 7 7 7 7 7 7 7 15 16 8
