-1 -1 -1 -1 -1 -1 -1 -1 -1 -1 -1 -1 -1 -1 -1 -1 -1 -1 -1
-1 49 50 51 -1 64 88 89 88 89 88 89 76 77 78 79 -1 98 190
-1 52 53 54 -1 64 90 91 90 91 90 91 80 81 82 83 -1 99 190
-1 55 56 57 -1 64 92 93 92 93 92 93 84 85 86 87 100 96 94
-1 -1 58 59 -1 -1 66 66 66 67 73 68 65 65 65 65 101 97 95
47 47 60 61 -1 -1 -1 -1 -1 -1 -1 -1 -1 -1 -1 -1 -1 -1 -1
48 48 62 63 -1 -1 -1 -1 -1 -1 -1 -1 -1 -1 -1 -1 -1 -1 -1
-1 -1 -1 -1 -1 -1 -1 -1 118 119 120 121 122 123 109 110 103 104 -1
-1 -1 -1 -1 -1 -1 -1 124 125 126 127 128 129 130 111 112 105 106 -1
-1 256 256 256 -1 -1 -1 131 132 133 134 135 136 137 113 114 107 108 -1
-1 256 256 256 -1 -1 -1 138 139 140 141 142 143 144 115 103 104 116 -1
-1 256 256 256 -1 -1 -1 -1 102 145 146 147 148 102 -1 105 106 117 -1
-1 256 256 256 -1 -1 -1 -1 -1 -1 -1 -1 -1 -1 -1 107 108 -1 -1
-1 256 256 256 -1 -1 -1 -1 -1 -1 -1 -1 -1 -1 -1 -1 -1 -1 74
-1 -1 -1 -1 -1 -1 -1 -1 -1 -1 -1 -1 -1 -1 -1 -1 -1 -1 75
178 179 179 179 180 -1 153 154 149 150 149 150 -1 -1 -1 -1 -1 -1 69
181 182 182 182 183 -1 155 156 151 152 151 152 -1 170 171 -1 -1 -1 70
184 185 185 185 186 -1 -1 159 160 161 162 157 158 172 173 -1 -1 -1 71
187 188 188 188 189 -1 -1 163 164 165 166 157 158 174 175 -1 -1 -1 72
-1 -1 -1 -1 -1 -1 -1 167 168 169 -1 157 158 176 177 -1 -1 -1 65
-1 -1 -1 -1 -1 -1 -1 -1 -1 -1 -1 -1 -1 -1 -1 -1 -1 -1 -1
